########
#     ##
#  #####
# # ####
### ####
########