####################
#         ######   #
#   ####       #   #
#   #        ####  #
# ###  ####        #
#   #     # #      #
#   #     #   ### ##
#   ### ###   # #  #
#     #   #   # #  #
###   #   ##### #  #
# #      ##        #
# #   ####   ###   #
#                  #
####################