#E######################################
# # #   #               #      #       #
# # # # ### ##### # # ### # ## # ## ## #
#   # #   # #   # # # #   # #  # #     #
### # ### # # ##### # # ### ## #     ###
#       # #     #   #   #     ##       #
####### # # ##########   ##### ##  ### #
#       # # # #   #     # #   #   #    #
# # ##### ### ### ### ### # # ### #   ##
#       # #   #     #   #   #     ## # #
##### # # # ### # # # ### ##### #### ###
# #   #     #   # #         #       #  #
# ####### ##### # ### # # ####### #### #
#     # #   # # #   # # # #     # #    #
# # # # # # # # ### ##### # # # # #### #
# # # # # # #   #   #       # # # #  # #
### ### ### # ### # ### ####### # # #  #
# #   # # #     # # #     #     # #  ###
# ### # # ### # # ### # # ### # #### # #
#       #   # # # # # # # #   #        #
# ### ### # # ### # ### ### ####### ## #
#   #   # #     #   # # # #   # #   #  #
### ### # # # ### ### # # ##### # # ####
#     #   # #   #     #                #
######################################S#