########################################
#         ######              ######   #
#   ####       #        ####       #   #
#   #        ####       #        ####  #
# ###  ####           ###  ####        #
#   #     # #           #     # #      #
#   #     #   ### ###   #     #   ### ##
#   ### ###   # #       ### ###   # #  #
#     #   #   # #         #   #   # #  #
#     #   ##### #  ####   #   ##### #  #
#                     #                #
E     ####   ###      #   ####   ###   S
#     #          ###                   #
#      ##########  #                   #
#                  ###                 #
#         ######              ######   #
#   ####       #        ####       #   #
#   #        ####       #        ####  #
# ###  ####           ###  ####        #
#   #     # #           #     # #      #
#   #     #   ### ###   #     #   ### ##
#   ### ###   # #       ### ###   # #  #
#     #   #   # #         #   #   # #  #
#                                      #
########################################