#E######################################
#  #   #       #   #   #               #
# ## ### ######### ### # ##### #### ####
#      #     # # # #   # #           # #
# ###### ##### # # # # # ####### ##### #
#    #     # # # #   #     #     #   # #
#  # # # ### # # # ### ####### # # ### #
#  #   # # # #     #   #   #   # # #   #
###### # # # # # # # ### # ####### ### #
#    # #       # # #     # #   # #   # #
# ## # ### ### # ### # ### # ### ### # #
#  #   #   #   # # # # #     #     #   #
# ## # # ##### ### ##### ### # ##### ###
#    # # #     # #     # #         #   #
# ## ### ####### ##### ####### ### ### #
#      # #   #           #   # #   #   #
## # ####### ### # ##### # ####### # # #
#  #   # # #   # #     #           # # #
## # ### # ### # ############### ### # #
#  #   #                     # #     # #
# ######################## # # # ##### #
#    # #   #       # # # # # # #       #
#  # # # ### ##### # # # # ### # # # # #
#  # #           #           #   # # # #
######################################S# 
