#E######################################
#         #         #             #    #
# ### # # # # ##### ####### ### #### ###
#   # # # # #   #     # #     #   #    #
# ####### ##### ### # # # # ### # #### #
# # # #     #   # # #   # # #   #   #  #
### # # # # ##### ### # # ####### #### #
#       # #   #   #   #   #   # # #    #
##### ########### # ##### # ### # # ####
# #   # #               #     # #    # #
# # ### # ####### # ######### # #### # #
#       # #   # # #   # #   # # #      #
####### ### ### ##### # ### ### ### ## #
# # # #           #     #   #          #
# # # # ### ### # # ####### ####### ## #
# #     #     # #     #              # #
# ### ######### ##### # ########### ####
# # # #       # #       #     #        #
# # ### ### ##### # ### # ####### ## ###
#     #   # # #   #   #         # #    #
# # ####### # ##### ### ### ##### # ####
# #     #   # #   # #     # #     #    #
# ####### # # # ### # # # ####### #### #
#         #         # # #   #          S
########################################