#E######################################
#       #       #        #   #   # #   #
# ##### # # ######## ### ### ### # # # #
#     # # # # # #      #             # #
# # # ### # # # # ########## # ### #####
# # #     #       # #        # #   #   #
# ##### ########### ###### ### ### # # #
# #   #     # #   # # #    # #   # # # #
### ##### # # # ### # # ### # # ###### #
#   # #   #   # #     # # # # #        #
# ### # ### ### # ##### # ### ## # ### #
#   #   #   #     # # # #      # #   # #
### ############# # # # ######## ### # #
# # #       #        #   #           # #
# # ##### ##### ### # # ### # # # ######
#   # #         # # # # #   # #    # # #
# # # ### ### # # ##### # ######## # # #
# #     # #   # #   #   #      #       #
### # # ####### # # ### ## # # # # # ###
#   # # #        #     # # # # # # #   #
### ############## # # # # # ####### ###
#       #    # # # # #     #   #   #   #
### ### ### ## # # # ### ### ### # ### #
#   #              # #     #     #     #
####################################S### 
