#E######################################
#    # #       #   #       #   # # # # #
#### # ##### ### # ##### # ### # # # # #
#        #     # #       # # #   # # # #
#  ####### # # # ########### # ### # # #
#      # # # #     #       # #         #
# #### # ##### ####### ### # # ### #####
#  #   #   # # #   #     #     #     # #
#  ####### # # # # # # ######### ##### #
#                #   #       #     # # #
######## # # ##### ### # ##### ### # # #
#  # #   # # # # #   # # #   # # # #   #
# ## ##### ### # # ##### # ### # # ### #
#      #     #   #   #     # # #       #
## ### # # ### ####### ### # ### ##### #
#    # # #   # #   #   #     # # #     #
#  ### ### ### # # # # # ### # ####### #
#  #         # # #   # #   # # #       #
#  ####### ### ##### ##### ### #########
#    # #     #   #     # #       #     #
# #### # ### ### ####### # ### ### # ###
#    #   # #     # #         #   # #   #
#  ##### # ##### # ### ##### # # ### ###
#       #       #   #         #        # 
#####################################S##
