########################################
#                                      #
#                                      #
#           #                          #
#           #                          #
#           #                          #
#           #                          #
#                                      #
#                              #       #
#                              #       #
#                              #       #
E             #######          #       S
#                              #       #
#                                      #
#             #                        #
#             #                        #
#             #                        #
#             #                        #
#             #                        #
#                                      #
#                                      #
#                  ######              #
#                                      #
#                                      #
########################################
