#E######################################
#                     # #           #  #
# ##### # ### # ### ### # # # # # ######
#   #   # #   # # # #     # # # #   #  #
# ##### ######### # ### ### ### ########
# #           # # #       #   #     # ##
# ##### ##### # # # ######### ####### ##
#     #     # #       # #   #   # # #  #
# ######### ####### # # ### # # # # # ##
#   #     # #   # # # # #   # # # #    #
##### # # ##### # # ### # ### ### # ## #
#     # # # # #   # #     #   #        #
##### ### # # # ### ##### ####### ######
#   # #       #   # # #     #          #
# ### ##### # # ### # ### # # ### ######
#       # # # # #         #     #      #
### ##### # # # # ####### # # # ########
#       #   # #   #       # # #   #   ##
# ### # ########### ### # ####### # # ##
#   # #     #       #   #     # # # #  #
# # # # ##################### # ##### ##
# # # # # # #   # # # #           #    #
### ### # # # # # # # # # ### ### # # ##
#   #         #         # #   #     #  S
########################################