#E######################################
# #     #       #           #      #   #
# ### ##### ##### ### # # #### ### # # #
# #       #   # # #   # #   #    #   # #
# # ### ### ### # ############ # ### ###
# #   # # #   #       # #    # # # # # #
# # # ### # ### ####### # ## # # # ### #
#   #           # # #   #  # # #       #
### ##### ### ### # # #### ##### ##### #
#   #     #              #     #     # #
####### ### ### ######## # ### # ##### #
#         # # # #    #   #   #   #   # #
# ######### # ##### ###### ##### ### # #
# #   #       #   #   #  #     #   #   #
# ### ##### ##### # ### # #### # #######
#   #     #   # #   #  # # # # # # #   #
### # ####### # # #### ### # # ### ### #
#   # #     # # # #  # # # #   #   #   #
### # # ### # # # # ## # # ### # ### # #
#   #   #       # #  #   #       #   # #
##### ##### ##### ### # #### ### ### ###
# #       #   #   #   # #    # #   # # #
# ### ### # # # # # ### # #### ### # # #
#       # # #   #           #          # 
##################################S##### 
