#E######################################
#                         #       #    #
# # ##### # # # ### ##### ### ## # # # #
#   #     # #   # #   #     # #    # # #
##### # ### ##### # ### ### ### ## # ###
#     # #     #   #   # #     # #  #   #
# # ### # ### ### # # ### ### ###### # #
# #   # #   # #   # # #     #  # #   # #
### ### ######### ##### ### #### ### ###
#   #     # # # #     # #      #   # # #
##### ##### # # ### # ## ###   # ### # #
#     #       #   ###     ###        # #
### ### ######### ### #### ### # ### # #
#       # #       #      #   # # # #   #
# ##### # # ### ##### ########## # # # #
#   #   # #   #       #     #      # # #
# ####### # # # ####### # #### # ##### #
#   # # #   # #        # #   #     #   #
# ### # # ### ### ### # ### #### ### # #
#   #       # #   #   #  #   #   # # # #
# ####### ####### ### ## ### ### # # # #
#     #   #   # # # # #    # #   #   # #
#   # # # # ### ### # ###### # ####### #
#       #   #           #      #       # 
###################################S####
